#######
#  #  #
#  #  #
#     #
#  #  #
#######
